11111111111111111111
1000100001C1C100C001
100C100CC1C1010111C1
1000100001C100010001
1P111C1111C111010111
1011000001000001C001
1010C1C1C11111C11101
1C10110100010000C101
1000C10001000101C1E1
11111111111111111111