11111111111111111111
1CC1CCC1CCC1CCCCCCC1
1CCC1KCCC1C11CC111C1
1CCC1CC1C1CC1CCCCKC1
1PC11C1111C111C1C111
1CC11CC1CCCCCCCKC1C1
1CC1CCC1C1CC1C11CCC1
1C1CC11CC1CC1CCC1CC1
1CCCCCC1CCC1CC1C1CE1
11111111111111111111