1111111111
1PKCCCCCC1
1CCCCCCEC1
1CCCCCCCC1
1111111111